R 1000 1000
NO ./srcs/walls/greystone.xpm
SO ./srcs/walls/redbrick.xpm
WE ./srcs/walls/colorstone.xpm
EA ./srcs/walls/mossy.xpm

S ./srcs/items/pillar.xpm
F 128, 43, 0
C 0, 204, 153

M
1111111111111
12000000000011111111111111111111111111111111
10000000000000000000000000000000000000000001
100000S0000011111111111111111111111111111111
1000000000011
1000012100001
1111111111111
