R 1000 1000
NO ./srcs/walls/greystone.xpm
SO ./srcs/walls/redbrick.xpm
WE ./srcs/walls/colorstone.xpm
EA ./srcs/walls/mossy.xpm

S ./srcs/items/pillar.xpm
F 128, 43, 0
C 0, 204, 153

M
           1111111111111111111111111
           1000000000000000000000001
111111111111000000000000000000000001
10000000000000000000000011111111111111111111111111111111111111111111111
10000000000000000000000000000000000000000000000000000000000000000000021
11111111100000000000000000000000111111111111111111111111111111111111111
100000000000000000000000000001111
10000000000000N000000000000111
10000000000000000000000000001
10000000000000000000000000001
10000000000000000000000000001
11111111111111111111111111111
