SO ./srcs/walls/redbrick.xpm
WE ./srcs/walls/colorstone.xpm
C 0, 204, 153
NO ./srcs/walls/greystone.xpm
F 128, 43, 0
S ./srcs/items/pillar.xpm
EA ./srcs/walls/mossy.xpm
R 500 500

M
111111111111
1200001211111
1000000000011
100020000001
100000200221
1000000N0021
100000020011
100000000001
100000000001
100000000001
100000000001
111111111111
