R 1000 1000
NO ewweqqq
SO dff
WE acbc
EA wlfjldjfl

S 안뇽하세요
F 220, 100, 0
C 225,225 ,255

//map이 가장 아래로 가야함
M
111111111111
120000000001
100000000001
100000000001
100000000011
100000E00001
100000000011
100000000001
100000000001
100000000021
100000000021
111111111111
