R 500 500

NO ./srcs/walls/greystone.xpm
SO ./srcs/walls/redbrick.xpm
WE ./srcs/walls/colorstone.xpm
EA ./srcs/walls/mossy.xpm

C 10, 204, 153
F 128, 43, 0
S ./srcs/items/pillar.xpm

M
111111111111
1200001211111
1000000000011
1000200001111111111111111111111111111
1000000000000000000000000000000000001
1000020N10211111111111111111111111111
100000020011
100000000001
100000000001
100000000001
100000000001
111111111111
