R 1000 1000
NO ./srcs/walls/greystone.xpm
SO ./srcs/walls/redbrick.xpm
WE ./srcs/walls/colorstone.xpm
EA ./srcs/walls/mossy.xpm

S ./srcs/items/pillar.xpm
F 128, 43, 0
C 0, 204, 153

M
111   1111111111111
101000000000  11
1111100E00000000011
110000000002000000011
10050000002000000001
1000010000000000011
100002000000001111
1000000002000000001
1000000000002000001
1000000000000000011
11111111111111111199
