R 1000 1000
NO ewweqqq
SO dff
WE acbc
EA wlfjldjfl

S 안뇽하세요
F 220, 100, 0
C 225,225 ,255

//map이 가장 아래로 가야함
M
	1111111111111
	10000000000011
1111100000000000011
11000000000000000011
1000000002000000001
1000010000000000011
100000000000000001
1000000002000000001
1000000000002000001
1000000000000000011
111111111111111111
