R 1000 1000
NO ./srcs/walls/greystone.xpm
SO ./srcs/walls/redbrick.xpm
WE ./srcs/walls/colorstone.xpm
EA ./srcs/walls/mossy.xpm

S ./srcs/items/pillar.xpm
F 128, 43, 0
C 0, 204, 153

M
11111
10201
10021
12001
10S01
10001
10201
11111
