R 210 230
NO ./srcs/walls/greystone.xpm
SO ./srcs/walls/redbrick.xpm
WE ./srcs/walls/colorstone.xpm
EA ./srcs/walls/mossy.xpm

F 25, 229, 134
C 1, 181, 242

//0,1,2,3,4 만 허용합니다.
M
        1111111111111111111111111
        1000000000000000000000001
        1100000000000000000000001
        1000000000040000000000001
11111111100000040000040000000011
10000000000000300300000000000011
100000000002000E10030000000011
100000000000300000000000000001
1000000000000003000000000000001
100000000000000000000000000011
10000000000000000001010000001
11000001110101011111011110101
11110111 1110121 101111010001
11111111 1111111 111111111111
