R 1000 1000
NO ./srcs/walls/greystone.xpm
SO ./srcs/walls/redbrick.xpm
WE ./srcs/walls/colorstone.xpm
EA ./srcs/walls/mossy.xpm

S ./srcs/items/pillar.xpm
F 25, 229, 134
C 0, 181, 242

M
11111111111111111
10200012111110101
100000101000100001
100000101000100001
100000001000100001
10000000100010001
10000000100010001
10000000000010001
100000000000000111
100000100000000001
100000000000000001
10000000 00000W001
10000000222000001
10000000000000001
11111111111111111
