R 1000 1000
NO ewweqqq
SO dff
WE acbc
EA wlfjldjfl

S 안뇽하세요
F 220, 100, 0
C 225,225 ,255

M
111111111111111111111
1000001211111000000001
100000101000000000011
100000101000000000001
100000000000000000001
1000000000N0000000001
100000000000000000001
100000000000000000001
100000000000000000001
100000000000000000001
111111111111111111111



