R 1000 1000
NO ewweqqq
SO dff
WE acbc
EA wlfjldjfl

S 안뇽하세요
F 220, 100, 0
C 225,225 ,255

M
11111111111111111
10200012111110101
10000010100000001111
100000101000000000001
100000000000000000001
1000000000N0000000001
100000002220000000001
100000002220000000001
100000002220000000001
100000002220000000001
100000002220000000001
10000000222000001111
10000000222000001
10000000000000001
10000000000000001
10000000000000001
11111111111111111



