R 500 500

NO ./srcs/walls/greystone.xpm
SO ./srcs/walls/redbrick.xpm
WE ./srcs/walls/colorstone.xpm
CFUU 10, 204, 153
F 128, 43, 0
S ./srcs/items/pillar.xpm
EA ./srcs/walls/mossy.xpm

M
111111111111
1200001211111
1000000000011
100020044001111111111111111111111111
1000000000000000000000000000000000001
1000020N102100..00000008000000000001
100000020011111111111111111111111111
100000000001
100000000001
100000000001
100000000001
111111111111
