R 500 500

NO ./srcs/walls/greystone.xpm
SO ./srcs/walls/redbrick.xpm
WE ./srcs/walls/colorstone.xpm
CFUU 10, 204, 153
F 128, 43, 0
S ./srcs/items/pillar.xpm
EA ./srcs/walls/mossy.xpm

M
111111111111
1200001211111
1000000000011
10002004400111111111111111
100000206660..0050000000.1
1000020N102111111111111111
100000220011
100000000001
100000000001
100000000001
100000000001
111111111111
